type octile
height 22
width 18
map
..................
..................
..@@..@@..@@..@@..
..@@..@@..@@..@@..
..................
..................
..@@..@@..@@..@@..
..@@..@@..@@..@@..
..................
..................
..@@..@@..@@..@@..
..@@..@@..@@..@@..
..................
..................
..@@..@@..@@..@@..
..@@..@@..@@..@@..
..................
..................
..@@..@@..@@..@@..
..@@..@@..@@..@@..
..................
..................